###############
#P OOOOOOOOO P#
# #O#O#O#O#O# #
#OOOOOOOOOOOOO#
#O#O#O#O#O#O#O#
#OOOOOOOOOOOOO#
#O#O#O#O#O#O#O#
#OOOOOOOOOOOOO#
#O#O#O#O#O#O#O#
#OOOOOOOOOOOOO#
# #O#O#O#O#O# #
#P OOOOOOOOO P#
###############