###################
#P OOOOOOOOOOOOO P#
# #O#O#O#O#O#O#O# #
#O#O#O#O#O#O#O#O#O#
#OOOOOOOOOOOOOOOOO#
#O#O#O#O#O#O#O#O#O#
#OOOOOOOOOOOOOOOOO#
#O#O#O#O#O#O#O#O#O#
#O#O#O#O#O#O#O#O#O#
#OOOOOOOOOOOOOOOOO#
#O#O#O#O#O#O#O#O#O#
#OOOOOOOOOOOOOOOOO#
#O#O#O#O#O#O#O#O#O#
# #O#O#O#O#O#O#O# #
#P OOOOOOOOOOOOO P#
###################