###############
#P           P#
# # # # # # # #
#             #
# # # # # # # #
#             #
# # # # # # # #
#             #
# # # # # # # #
#             #
# # # # # # # #
#P           P#
###############